8,23,23,24,99,99,22,23,23,9
14,33,33,34,99,99,32,33,33,12
14,99,99,99,99,99,99,99,99,12
14,99,99,99,99,99,99,99,99,12
14,99,99,99,99,99,99,99,99,12
14,99,99,99,99,99,99,99,99,12
14,99,99,99,99,99,99,99,99,12
14,99,99,99,99,99,99,99,99,12
14,99,99,99,99,99,99,99,99,12
14,99,99,99,99,99,99,99,99,12
18,3,3,3,3,3,3,3,3,19
13,13,13,13,13,13,13,13,13,13